acknowledge=v [T] (17) to accept that something is true or exists
adequately=adv (16) in a satisfactory way; in the amount or to the degree needed
article=n [C] (14) a piece of writing in a magazine
clarification=n [C/U] (20) an explanation or more details which makes something clear or easier to understand
common knowledge=phr (14) something that a lot of people know
communicable=adj (17) able to be given from one person to another
deficit=n [C] (17) the amount by which the money that you spend is more than the money that you recieve
disproportionately=adv (16) in a way that is too large or too small in comparison to something else
draft=v [T] (14) to produce a piece of writing or a plan that you intend to change later
extent=n (20) the size or importance of something
extrinsic=adj (14) coming from outside, or not related to something
hypothesise=v [I/T] (25) to give a possible but not yet proved explanation for something
infer=v [T] (14) to guess that something is true because of the information that you have
influence=v [T] (20) to affect or change how someone or something develops, behaves or thinks
influence=n [C/U] (22) the power to affect how someone thinks or behaves, or how something develops, or someone or something that has this effect
interpret=v [T] (24) to explain or decide what you think a particular phr, performance, action, etc means
intrinsic=adj (14) an intrinsic quality or things forms part of the basic character of something or someone
minority=n [C] (16) a part of a group which is less than half of the whole group, often much less
outcome=n [C] (17) the final result of an activity or process
peer pressure=n [U] (14) strong influence on a member of a group to behave the same as the others in the group
progress=n [U] (16) development and improvement of skills, knowledge, etc
recognition=n [U] (17) when you accept that something is true or real
remit=n [U] (17) the things that you are responsisble for in your job
scope=n [U] (17) the range of a subject covered by a book, programme, discussion, class, etc
social status=n [U] (14) position or importance in a social group
source=n [C] (14) where something comes from
statistic=n [C] (15) (usually plural) a fact in the form of a number that shows information about something
step sth up=phr v (17) to increase the size, amount or speed of a process that is intended to achieve something
thesis statement=n [C] (17) a sentence near the start of an essay in which the writer presents their main idea
unsustainable=adj (22) something that is unsustainable cannot continue at the same rate
widespread=adj (17) affecting or including a lot of places, people, etc